XXXXXXXXXXXXXXXX
X   FFF  X     X
X X XX X X X  XX
X X X* X     X X
X      XX X XXXX
XXX XX X X   X X
XX   X FFF XX  X
XXX   X X  X X X
X XH X   X X   X
XXX*XFXFX  X X X